//Behroz Kooling
.o.........
oo..ooooooX
....o......
....o.ooo..
....o.o.o..
Soo.o.o.o..
..o.ooo.o..
..o.....o..
..ooooooo..
..........o
