// Map by OGG
..........S........ooooooooooooooooooooooooooooooooooooooooooooooooooooooo..ooooo.
..........o........o.....................................................o..o...o.
..........o........o.....................................................o..o...o.
..........o........o.....................................................o..o...o.
..........o........oooooooooooooooooooooooooooooo........................o..o...o.
..........o.....................................o........................o..o...o.
..........o.....................................oooooooooooooo...........o..o...o.
..........o..................................................o...ooooo...o..o...o.
..........o..................................................o...o...o...o..o...o.
..........oooooooooooooooooooooooooooooooooooooooooooooooooooo...o...o...o..o...o.
.................................................................o...o...o..o...o.
.................................................................o...o...o..o...o.
.................................................................o...o...o..o...o.
.................................................................o...o...o..o...o.
.................................................................o...o...o..o...o.
.................................................................o...ooooo..o...o.
...oooooooooooooooooooooooooooooooooooooooooooooooooo............o..........o...o.
...o................................................o............o..........o...o.
...o................................................o............o....oooo..o...o.
...o................................................o............o....o..o..o...o.
...o...........oooooooooooooooooooooooooooooooooooooo............o....o..o..o...o.
...o...........o.................................................o....o..o..o...o.
...o...........o.................................................o....o..oooo...o.
...o...........o.................................................o....o.........o.
...o...........ooooooooooooooooooooooooooooooooooooooooooooooooooo....oooo......o.
...o.....................................................................o......o.
...o.....................................................................o......o.
...ooooooooooooooooooooooooooooooooooooooooooooooooooooooooooooooooooooooo......o.
................................................................................o.
oooooooooooooooooooooooooooooooooooo............................................o.
o..................................o............................................o.
o..................................o.........oooooooooooooooooooooooooooooooooooo.
o...oooooooooooooo.................o.........o....................................
o...o............o.................o.........o....................................
o...o............o.................o.........o........ooooooooooooooooooooooooooo.
o...o............o.................o.........o........o.........................o.
o...o............o.................o.........o........o.........................o.
o...o............o.................o.........o........o.......ooooooooooooo.....o.
o...o............o.................o.........o........o.......o...........o.....o.
o...o............o.................o.........o........o.......o...........o.....o.
o...o............o.................o.........o........o.......o...........o.....o.
o...o............o.................o.........o........o.......o...........o.....o.
o...o............o.................o.........o........o.......o...........o.....o.
o...o............o.................o.........o........o.......o...........o.....o.
o...o............o.................o.........o........o.......o...........o.....o.
o...o............o.................o.........o........o.......o...........o.....o.
o...o............o.................o.........o........o.......o...........o.....o.
o...o............o.................o.........o........o.......o...........o.....o.
o...o............o.................o.........o........o.......o...........o.....o.
o...o............ooooooooooooooooooo.........o........o.......o...........o.....o.
o...o........................................o........o.......o...........o.....o.
o...o........................................o........o.......o...........o.....o.
o...oooooooooooooooooooooooooooooooooooooooooo........o.......o...........o.....o.
o.....................................................o.......o...........o.....o.
o.....................................................o.......o...........o.....o.
o.....................................................o.......o...........o.....o.
o.....................................................o.......o...........o.....o.
o.....................................................o.......o...........o.....o.
o.....................................................ooooooooo...........o.....o.
o.........................................................................o.....o.
o.........................................................................o.....o.
ooooooooooooooooooooooooooooooooooooooooooooooooooooooooooooooooooooooooooo.....o.
................................................................................o.
................................................................................o.
................................................................................o.
................................................................................o.
................................................................................o.
................................................................................o.
................................................................................o.
..............................ooooooooooooooooooooooooooooooooooooooooooooooooooo.
..............................o...................................................
..............................o...................................................
..............................o...................................................
..............................o...................................................
..............................X...................................................
